Pick up all the waterdrops and reach the exit in time.
13 11
60
.............
...........X.
..........###
WWW..........
---....WWWW..
.......####..
....WWW#.....
--..####.....
.............
.1........W.W
#############